BBBBBBBBBBBBBBBBBBBB

BBBBBBBBBBBBBBBBBBBB

BBBBBBBBBBBBBBBBBBBB


BBBBBBBBBBBBBBBBBBBB

BBBBBBBBBBBBBBBBBBBB

BBBBBBBBBBBBBBBBBBBB
BBBBCBBBCBBBBBBBBBBB
PBBBGGBGGBBBBCBBBBZW
GGLLLLLLLLLGGGGBBGGG




