BBBBBBBBBBBBBBBBBBBB

BBBBBBBBBBBBBBBBBBBB

BBBBBBBBBBBBBBBBBBBB

BBBBBBBBBBBBBBBBBBBB




BBBBMBBBBBBBBBBBBBBB
PEBBBBBBBBBCBBBEBBZW
GGGGGBGBBGGGBBGGGGGG
SSSSSSSSSSSSSSSSSSSS