BBBBBBBBBBBBBBBBBBBB

BBBBBBBBBBBBBBBBBBBB

BBBBBBBBBBBBBBBBBBBB

BBBBBBBBBBBBBBBBBBBB




BMBCBBBBCBBBCBBBBBBB
 P E         E
GGBGGBGGBGGBGBGBBBZW
SSSSSSSSSSSSSSSGGGGG