BBBBBBBBBBBBBBBBBBBB

BBBBBBBBBBBBBBBBBBBB

BBBBBBBBBBBBBBBBBBBB

BBBBBBBBBBBBBBBBBBBB

BBBBGGGGGBBBBBBBBBBB

PBBCCBBBBBCBBBBBBBBB
GGGGGGGGGGBBBBBBBBZW
BBBBBBBBBBBGGGGGGGGG

SSSSSSSSSSSSSSSSSSSS



