BBBBBBBBBBBBBBBBBBBB

BBBBBBBBBBBBBBBBBBBB

BBBBBBBBBBBBBBBBBBBB

BBBBBBBBBBBBBBBBBBBB



BBBBBBBBBBBBBBBBBBBB
PBBCBBBBCBBBCBBBBBBB
GGEGGBGGGGGBGBGBBBZW
BBBBBBBBBBBBBBBEGGGG
LLLLLLLLLLLLLLLLLLLL