BBBBBBBBBBBBBBBBBBBB

BBBBBBBBBBBBBBBBBBBB

BBBBBBBBBBBBBBBBBBBB

BBBBBBBBBBBBBBBBBBBB



BBBBBMBBBBBBBBBBBBBB
PBECBBBBCBBBCBEBBBBB
GGBGGBGGGGGBGBGBBBZW
BBBBBBBBBBBBBBBBEGGG
LLLLLLLLLLLLLLLLLLLL