BBBBBBBBBBBBBBBBBBBB

BBBBBBBBBBBBBBBBBBBB

BBBBBBBBBBBBBBBBBBBB

BBBBBBBBBBBBBBBBBBBB




BBBBMBBBBBBBBBBBBBBB
BEBBBBBBBBBCBBBEBBZW
GGGGBBGBBGGGBBGGGGGG
SSSSSSSSSSSSSSSSSSSS