BBBBBBBBBBBBBBBBBBBB

BBBBBBBBBBBBBBBBBBBB

BBBBBBBBBBBBBBBBBBBB

BBBBBBBBBBBBBBBBBBBB

BBBBBBBBBBBBBBBBBBBB

BBBBBBBBBBBBBBBBBBBB
BBBBCBBBCBBBBBBBBBBB

BBBBGGBGGBBBBCBBBBZW
GGLLLLLLLLLGGGGBBGGG




15 висота
20 ширина