BBBBBBBBBBBBBBBBBBBB

BBBBBBBBBBBBBBBBBBBB

BBBBBBBBBBBBBBBBBBBB

BBBBBBBBBBBBBBBBBBBB

BBBBGOGGGBBBBBBBBBBB

BEEBBBBBBBBBBBBBBBBB
GGGGGGGGGGSSBBBBBBZW
BBBBBBGGGGGGGGGGGGGG

SSSSSSSSSSSSSSSSSSSS



