BBBBBBBBBBBBBBBBBBBB

BBBBBBBBBBBBBBBBBBBB

BBBBBBBBBBBBBBBBBBBB

BBBBBBBBBBBBBBBBBBBB




BMBCBBBBCBBBCBBBBBBB
 E         E
GGBGGBGGBGGBGBGBBBZW
SSSSSSSSSSSSSSSGGGGG