BBBBBBBBBBBBBBBBBBBB

BBBBBBBBBBBBBBBBBBBB

BBBBBBBBBBBBBBBBBBBB

BBBBBBBBBBBBBBBBBBBB

BBBBGOGGGBBBBBBBBBBB

PEBBBBBBBBBBBBBBBBBB
GGGGGGGGGGSBBBBBBBZW
BBBBBBGGGGGGGGGGGGGG

SSSSSSSSSSSSSSSSSSSS



