BBBBBBBBBBBBBBBBBBBB

BBBBBBBBBBBBBBBBBBBB

BBBBBBBBBBBBBBBBBBBB

BBBBBBBBBBBBBBBBBBBB



BBBBBMBBBBBBBBBBBBBB
BBECBBBBCBBBCBEBBBBB
GGBGGBGGGGGBGBGBBBZW
BBBBBBBBBBBBBBBBEGGG
LLLLLLLLLLLLLLLLLLLL