Level 1

BBBBBBBBBBBBBBB
BBSBBBBBBBBBBBB
BBBBBBBBBBBBBBB
BBBBBBBBBBBBBBB
BBBBCBBBCBBBBBB
BBBBGGBGGBBBBBB
GGLLLLLLLLLGGZW

Level 2

BBBBBBBBBBBBBBB
BBBBBBBBBBBBBBB
BBBBBBBBBBBBBBB
BBBBBBBBBBBBBBB
BBBBGOGGGBBBBBB
BBBBBBBBBBBGBBB
GGGGEEGGGGSSSZW

Level 3

BBBBBBBBBBBBBBB
BBSBBBBBBBBBBBB
BBBBBBBSBBBBBBB
BBSBBBBBBBBBBBB
BMBBBBBBBBBCBBB
GGGEBBGBBGGGBBB
LLLLBBSSBLLLBZW

Level 4

BBBBBBBBBBBBBBB
BBBBBBBBBBBBBBB
BBBBBBBBBBBBBBB
BBBBBBBBBBBBBBB
BMBCBBBBCBBBCBB
GGGGGEGGGGGEGGG
SSSSSSSSSSSSSZW

Level 5

BBBBBBBBBBBBBBB
BBSBBBBBBBBBBBB
BBBBBBBBBBBBBBB
BBBBBBBBBBBBBBB
BMBCBBBBCBBBCBB
GGBGGEGGBGGEGBG
LLLLLLLLLLLLSZW


