Level 1

BBSBBBBBBBBBBBB
BBSBBBBBBSBBBBB
BBBBBBBSBBBBBBB
BBSBBBBBBBBBBBB
BBBBCBBBCBBBBBB
BBBBGBBBGBBBBBB
GGLLLLLLLLLGGZW

Level 2

BBSBBBBBBBBBBBB
BBSBBBBBBSBBBBB
BBBBBBBSBBBBBBB
BBSBBBBBBBBBBBB
BBBBGOGGGBBBBBB
BBBBBBBBBBBGBBB
GGGGEEGGGGSSSZW

Level 3

BBSBBBBBBBBBBBB
BBSBBBBBBSBBBBB
BBBBBBBSBBBBBBB
BBSBBBBBBBBBBBB
BMBBBBBBBBBCBBB
GGGEBBGBBGGGBBB
LLLLBBSSBLLLBZW

Level 4

BBSBBBBBBBBBBBB
BBSBBBBBBSBBBBB
BBBBBBBSBBBBBBB
BBSBBBBBBBBBBBB
BMBCBBBBCBBBCBB
GGGGGEGGGGGEGGG
SSSSSSSSSSSSSZW


