BBBBBBBBBBBBBBBBBBBB

BBBBBBBBBBBBBBBBBBBB

BBBBBBBBBBBBBBBBBBBB

BBBBBBBBBBBBBBBBBBBB

BBBBGGGGGBBBBBBBBBBB

PBBBBBBBBBBBBBBBBBBB
GGGGGGGGGGBBBBBBBBZW
BBBBBBGGGGGGGGGGGGGG

SSSSSSSSSSSSSSSSSSSS



