BBBBBBBBBBBBBBBBBBBB

BBBBBBBBBBBBBBBBBBBB

BBBBBBBBBBBBBBBBBBBB

BBBBBBBBBBBBBBBBBBBB




BBBCBBBBCBBBCBBBBBBB
 P
GGEGGBGGBGGBGEGBBBZW
SSSSSSSSSSSSSSSGGGGG