BBBBBBBBBBBBBBBBBBBB

BBBBBBBBBBBBBBBBBBBB

BBBBBBBBBBBBBBBBBBBB


BBBBBBBBBBBBBBBBBBBB

BBBBBBBBBBBBBBBBBBBB

BBBBBBBBBBBBBBBBBBBB
BBBBCBBBCBBBBBBBBBBB
PBBGGGBGGBBBBCBBBBZW
GGLLLLLLLLLGGGGBBGGG




