BBBBBBBBBBBBBBBBBBBB

BBBBBBBBBBBBBBBBBBBB

BBBBBBBBBBBBBBBBBBBB

BBBBBBBBBBBBBBBBBBBB




BBBBBBBBBBBBBBBBBBBB
PBBBBBBBBBBCBBBBBBZW
GGGGGBGEGGGGBBGGGGGG
SSSSSSSSSSSSSSSSSSSS